111111
1PC1E1
1C0001
111111