11111111
10C1E101
1001C101
1P000101
11111111