11111111
10P0C1C1
1C0001C1
1EC001C1
11110001
11111111