1111111111111111111111111111111111111111111111111111111111111
111111111111111111111111111111111111111111111111111111PCE1111
1111111111111111111111111111111111111111111111111111111111111