111111111111111111111111111111111111111111111111111111111111
1P0000000000000000011110000000000000000000000000000000001111
10001111111111000C001111000111111111100000011111111110000001
100000000000010000000000000100000000100000010000000010000001
100000000000011111100000000100000000111111110000000010000001
100000000000000000100000000100000000000000000000000010000001
111111111111100000111111111100000000000000011111111110000001
100000000001100000000000000000000000000000000000000010000001
100000000001111111000000000000111111111111100000000010000001
100000000001000001000000000000100000000001100000000010000001
100000000001000001000000000000100000000001111111100010000001
100000000001000001000000000000100000000000000000100010000001
100000000001000001111111111111111111100000000000100010000001
100000000001000000000000000000000000100000000000100011111111
100000000001111111111111111111111000100000000000100000000001
100000000000000000000000000000011000100000000000100000000001
100000111111111100000000111000011000100000000000100000000001
100000100000000100000000101000011000100000000000111111000001
100000100000000111111000101000011000100000000000000001000001
100000100000000000001000101000011000100000000000000001000001
100000100000000000001000101000011000100000000000000001000001
100000111111100000001000101000011000100000000000000001000001
100000000000100000001000101000011000111111110000000001000001
100000000000100000001000101000011000000000010000000001000001
111111111000111111111000111111111000000000010000000001000001
100000001000000000000000000000000000000000010000000001000001
1000000001000000000000000000000000000000000111111111110000E1
111111111111111111111111111111111111111111111111111111111111